{
  "A": "B",
  "B": "o",
  "C": "F",
  "D": "V",
  "E": "w",
  "F": "Z",
  "G": "r",
  "H": "i",
  "I": "q",
  "J": "E",
  "K": "b",
  "L": "a",
  "M": "c",
  "N": "e",
  "O": "j",
  "P": "z",
  "Q": "A",
  "R": "U",
  "S": "D",
  "T": "p",
  "U": "l",
  "V": "K",
  "W": "v",
  "X": "d",
  "Y": "k",
  "Z": "O",
  "a": "P",
  "b": "I",
  "c": "n",
  "d": "N",
  "e": "J",
  "f": "T",
  "g": "S",
  "h": "R",
  "i": "X",
  "j": "m",
  "k": "g",
  "l": "Y",
  "m": "H",
  "n": "h",
  "o": "G",
  "p": "M",
  "q": "Q",
  "r": "C",
  "s": "s",
  "t": "u",
  "u": "y",
  "v": "x",
  "w": "t",
  "x": "W",
  "y": "L",
  "z": "f"
}